####################
#         #        #
#  ## ##  #  ####  #
#  ## ##  #  ####  #
#                  #
#  ####      ####  #
#                  #
#####   ###    #####
#   # #  #  #  #   #
#   # ##   ##  #   #
#     #  #  #      #
#  #    ###    #   #
#  #           #   #
#     #######      #
#        #         #
#  ###   #    ###  #
#                  #
#     #######      #
#        #         #
####################

####################
#         #        #
#  ## ##  #  ####  #
#  ## ##  #  ####  #
#                  #
#  ####      ####  #
#                  #
#####   ###    #####
#   # #  #  #  #   #
#   # ##   ##  #   #
#     #  #  #      #
#  #    ###    #   #
#  #           #   #
#                  #
#                  #
#  ###        ###  #
#                  #
#     #######      #
#        #         #
####################

####################
#         #        #
#  ## ##  #  ####  #
#  ## ##  #  ####  #
#                  #
#  ####      ####  #
#                  #
#####   ###    #####
#   # #  #  #  #   #
#   # ##   ##  #   #
#     #  #  #      #
#  #    ###    #   #
#  #           #   #
#     #######      #
#        #         #
#  ###   #    ###  #
#                  #
#     #######      #
#        #         #
####################

####################
#         #        #
#  ## ##  #  ####  #
#  ## ##  #  ####  #
#                  #
#  ####      ####  #
#                  #
#####   ###    #####
#   # #  #  #  #   #
#   # ##   ##  #   #
#     #  #  #      #
#  #    ###    #   #
#  #           #   #
#                  #
#                  #
#  ###        ###  #
#                  #
#     #######      #
#        #         #
####################