████████████████████
█         █        █
█  ██ ██  █  ████  █
█  ██ ██  █  ████  █
█                  █
█  ████      ████  █
█                  █
█████   ███    █████
█   █ █  █  █  █   █
█   █ ██   ██  █   █
█     █  █  █      █
█  █    ███    █   █
█  █           █   █
█     ███████      █
█        █         █
█  ███   █    ███  █
█                  █
█     ███████      █
█        █         █
████████████████████

████████████████████
█         █        █
█  ██ ██  █  ████  █
█  ██ ██  █  ████  █
█                  █
█  ████      ████  █
█                  █
█████   ███    █████
█   █ █  █  █  █   █
█   █ ██   ██  █   █
█     █  █  █      █
█  █    ███    █   █
█  █           █   █
█                  █
█                  █
█  ███        ███  █
█                  █
█     ███████      █
█        █         █
████████████████████

████████████████████
█         █        █
█  ██ ██  █  ████  █
█  ██ ██  █  ████  █
█                  █
█  ████      ████  █
█                  █
█████   ███    █████
█   █ █  █  █  █   █
█   █ ██   ██  █   █
█     █  █  █      █
█  █    ███    █   █
█  █           █   █
█     ███████      █
█        █         █
█  ███   █    ███  █
█                  █
█     ███████      █
█        █         █
████████████████████

████████████████████
█         █        █
█  ██ ██  █  ████  █
█  ██ ██  █  ████  █
█                  █
█  ████      ████  █
█                  █
█████   ███    █████
█   █ █  █  █  █   █
█   █ ██   ██  █   █
█     █  █  █      █
█  █    ███    █   █
█  █           █   █
█                  █
█                  █
█  ███        ███  █
█                  █
█     ███████      █
█        █         █
████████████████████