████████████████████
█         █        █
█  ██ ██  █  ████  █
█  ██ ██  █  ████  █
█                  █
█  ████      ████  █
█                  █
█████   ███    █████
█   █ █  █  █  █   █
█   █ ██   ██  █   █
█     █  █  █      █
█  █    ███    █   █
█  █           █   █
█     ███████      █
█        █         █
█  ███   █    ███  █
█                  █
█     ███████      █
█        █         █
████████████████████

████████████████████
█                █ █
████ ███  █  ██	██ █
█ █  ██  █ █ █ █ █ █
█ █  ███ █ █ █   █ █
█                  █
█  █████████████   █
███    █████    ██ █
█   ██  █ █  ██    █
█   ██ █ █ █ ██    █
█     █ ███  █     █
█  █     █     █   █
█  ██         ██   █
█ ███ ██  █ ██████ █
█ █   █ █ █  █ ███ █
█ ███ █  ██  █ █  ██
█   █          █   █
█   █  ██  ██  █   █
█       ████       █
████████████████████

████████████████████
█                  █
█ ████████████████ █
█                  █
█ █ ████████████ █ █
█ █              █ █
█ █ █ ████████ █ █ █
█ █ █          █ █ █
█ █ █ █ ████ █ █ █ █
█ █ █ █      █ █ █ █
█ █ █ █      █ █ █ █
█ █ █ █ ████ █ █ █ █
█ █ █          █ █ █
█ █ █ ████████ █ █ █
█ █              █ █
█ █ ████████████ █ █
█                  █
█ ████████████████ █
█                  █
████████████████████

████████████████████
█                ███
█    ██    ██     ██
█ ██ ██ ██ ██ ██   █
█    ██    ██     ██
█ ██ ██ ██ ██ ██ ███
█    ██    ██     ██
█ ██ ██ ██ ██ ██   █
█                 ██
█ ██ ██ ██ ██ ██ ███
█    ██    ██     ██
█ ██ ██ ██ ██ ██   █
█    ██    ██     ██
█ ██ ██ ██ ██ ██ ███
█    ██    ██     ██
█ ██ ██ ██ ██ ██   █
█    ██    ██     ██
█ ██ ██ ██ ██ █  ███
█                 ██
████████████████████
